'si (접미사): 복수형
-acto (접미사): 능동형
-hig (접미사): 가장 (최상급)
-iscau (접미사): ~때문에, ~의 해서
-komi (접미사): ~보다
-mo (접미사): 더 (비교급)
-ni (부정어(로컬)): ~하지 않다
-pato (접미사): 피동형
-po (접미사): 완료, 경험적 과거
-singo (접미사): ~하고 있다
Noti (부정어(글로벌)): 아니다, 하지 않다
Whispi (의문표지): 의문을 나타냄
afcrom (부사): 이후
alcrom (명사): 항상
alre (부사): 이미
ando (접속사): 그래서
anjoko (명사): 화
anvjok (형용사): 무겁다
aptos (명사): 의자 / 좌석
bajoko (명사): 혐오
baok (형용사): 나쁘다
becrom (부사): 이전
belom (명사): 소지품 / 물건
bidos (명사): 베개 / 침구
biok (형용사): 크다
blandos (명사): 이불 / 담요
bojok (형용사): 피곤하다 / 힘들다
bosus (동사): 부수다
brivos (명사): 테이블 / 책상
budo (접속사): 하지만
clocros (명사): 시계 / 시간계측기
clomo (부사): 가까이
cojoko (명사): 슬픔
coptivus (동사): 닫다
crom (명사): 시간
cutos (명사): 컵 / 잔
dayos (명사): 낮
decotolis (명사): 거울 / 반사체
delio (명사): 인사 (헤어질 때)
dinjok (형용사): 지루하다 / 재미없다
dis (명사): 오늘
divus (동사): 죽다
dopos (명사 / 전치사): 아래
dritos (명사): 칼 / 검
ducrom (부사): 동안
emio (명사): 눈
endo (접속사): 그리고
evcrom (명사): 매일
evdis (명사): 점심
evros (명사): 숟가락 / 젓가락
expos (명사 / 전치사): 밖 / 외부
falok (형용사): 멀다
famaio (명사): 가족
farmo (부사): 멀리
fazifus (명사): 가을
fijok (형용사): 시원하다 / 쾌적하다
fiksus (동사): 고치다 / 수리하다
filem (명사): 불
filemoros (명사): 가스 / 가스불
fimaio (명사): 친구
fisus (동사): 느끼다
fo' (접두사): 미래 시제
fodis (명사): 어제
fomio (명사): 동물
foro (접속사): ~하기 위해 (목적)
frimos (명사): 냉장고
frok (전치사): ~부터
fulmo (부사): 매우
futos (명사): 접시 / 그릇
ga (조사): 이/가
gabdos (명사): 가방 / 배낭
giok (형용사): 좋다
givus (동사): 주다
golo (감탄사): 고마워
hajoko (명사): 행복 / 기쁨
halus (동사): 놀다 / 여가를 즐기다
hamaio (명사): 부모
hasko (명사): 하늘
hav (조동사): 해야 한다
higsis (명사): 도시 / 나라
hilos (명사): 위치 / 장소
himaio (대명사): 그
hios (명사): 집
hiosis (명사): 마을
hojok (형용사): 무섭다
homaio (의문사): 누구
humaio (명사): 형제 / 자매 / 남매
humio (명사): 손 / 발
hutos (명사): 바닥 / 지면
hwok (형용사): 새롭다
ifo (접속사): 만약 / ~라면
ilos (명사): 건물
ilvos (명사): 문 / 출입구
inlius (동사): 있다 / 존재하다
inpos (명사 / 전치사): 안 / 내부
itos (대명사): 그것
ji (조사): 은/는
juvos (명사): 창문 / 유리
kanon (조동사): 할 수 있다
kero (명사): 열쇠 / 잠금장치
kiro (전치사): ~에 / ~으로 / ~로
kivus (동사): 웃다
lalem (명사): 흙 / 땅
lamaio (명사): 아이
lemaio (명사): 학생
lesius (동사): 배우다 / 공부하다
lilos (명사): 병원
lirus (동사): 듣다 / 귀 기울이다
lis (동사): ~이다, ~하다
litok (형용사): 적다
litolem (명사): 번개 / 천둥
litolemoros (명사): 전기 / 전원
livus (동사): 살다 / 생존하다
loaus (동사): 걷다
locrom (부사): 오래
lojoko (명사): 사랑 / 호감
lokus (동사): 보다 / 바라보다
lomaio (명사): 연인
los (명사): 길 / 거리
lothio (명사): 옷 / 의류
lousus (동사): 가다
maio (명사): 사람
manok (형용사): 많다
masus (동사): 만들다 / 창조하다
meko (명사): 약
mimaio (대명사): 나
mimos (명사): 휴대폰 / 기기
miogos (명사): 영화 / 영상
mivus (동사): 움직이다 / 활동하다
modis (명사): 아침
molus (명사): 달
monos (명사): 돈
motos (명사): 교통수단 / 차량
nelok (형용사): 가깝다
nicrom (부사): 절대 / 전혀
nidis (명사): 저녁
nijok (형용사): 춥다
nimos (동사): 충전하다 / 전원 연결
niyos (명사): 밤
nomios (명사): 이름
nore (부사): 아직
odo (접속사): 또는 / 이 아니면
ofcrom (명사): 자주
opros (명사): 가방 속 물건 / 소지품
optivus (동사): 열다
pa' (접두사): 과거 시제
padis (명사): 내일
parmo (부사): 부분적으로
pifilem (명사): 연기 / 향기
pilos (명사): 카페 / 휴식 공간
pios (명사): 고향
piroasio (명사): 간식 / 음식 종류
pishio (명사): 스위치 / 버튼
pishiorus (동사): 누르다
primos (명사): 장보기 / 쇼핑
prolus (명사): 사건
qimus (동사): 사다 / 구입하다
raus (동사): 먹다
recus (동사): 받다
relio (명사): 인사 (만날 때)
remivus (동사): 기억하다 / 생각나다
resus (동사): 읽다
ricrom (명사): 지금
rimos (명사): 카드 / 결제 수단
rios (명사): 시장 / 식당
roasio (명사): 음식 / 밥 / 끼니
roasus (동사): 요리하다 / 조리하다
rojok (형용사): 배고프다
rolus (동사): 설거지하다 / 씻다
romos (명사): 집안 / 방
rul (조사): 을/를
samaio (명사): 조부모
sasko (명사): 우주
setius (동사): 보내다 / 전달하다
shavo (접속사): ~하는 동안
shomos (명사): 샤워기 / 수도
siljok (형용사): 밝다 / 환하다
silus (명사): 빛
simaio (명사): 선생님
sinjok (형용사): 쉽다 / 간단하다
siogos (명사): 음악 / 노래
siok (형용사): 작다
siomaio (대명사): 그녀
sios (명사): 학교 / 학원
sipi (형용사): 똑똑한 / 현명한 / 지혜로운
sirvus (동사): 울다 / 눈물 흘리다
sitolis (명사): 책
sizifus (명사): 봄
slepus (동사): 자다
socrom (명사): 가끔 / 때때로
solo (감탄사): 미안해
solus (명사): 태양
soncrom (명사): 곧
sopidos (명사): 비누 / 세제
sopus (동사): 숨다 / 감추다
speok (형용사): 빠르다
spius (동사): 말하다
surjoko (명사): 놀람
suzifus (명사): 여름
teso (지시사): 저것 / 저
ticjok (형용사): 어렵다 / 복잡하다
tidos (명사): 휴지 / 종이
timaio (대명사): 그들
tiso (지시사): 그것 / 그
toi (조사): 에게
tolis (명사): 물건 / 도구
tolos (명사): 가게 / 상점
tomeko (명사): 치약 / 세정제
torio (명사): 시간 단위 (시/분)
torus (동사): 생각하다 / 고민하다
toso (지시사): 이것 / 이
tothio (명사): 이 / 이빨
totmo (부사): 완전히
totolis (명사): 칫솔 / 청결도구
trados (명사): 쓰레기 / 폐기물
trimos (명사): 편지 / 문서
tumaio (명사): 친척
twodos (명사): 수건 / 행주
ui (조사): 의
unjoko (명사): 아픔
unlius (동사): 없다 / 존재하지 않다
upos (명사 / 전치사): 위
urvos (명사): 약 / 의료용품
usus (동사): 사용하다
vijok (형용사): 덥다
vomos (명사): 가구 / 집안 물건
vrimos (동사): 복용하다 / 사용하다
wacrous (동사): 기다리다
walem (명사): 물
walus (동사): 마시다
wamos (명사): 싱크대 / 세면대
wav (조동사): 하고 싶다
wethio (명사): 날씨
whi (의문사): 왜
whicro (의문사): 언제
whihow (의문사): 어떻게
whilo (의문사): 어디
whito (의문사): 무엇
wilem (명사): 바람
wili (조동사): 할 것이다
wimaio (대명사): 우리
wizifus (명사): 겨울
wolgos (명사): 직업
wolus (동사): 일하다 / 노동하다
wrisus (동사): 쓰다
yumaio (대명사): 너
zifus (명사): 계절
